0 0 0 6 0 0 0 1 2
5 0 0 2 0 0 0 0 0
2 4 9 0 0 0 0 0 0
4 0 0 0 0 0 2 9 0
1 0 0 7 0 4 0 0 6
0 6 3 0 0 0 0 0 8
0 0 0 0 0 0 5 6 9
0 0 0 0 0 1 0 0 3
8 7 0 0 0 6 0 0 0


