0 6 7 8 0 9 4 5 0
0 0 0 0 6 0 0 0 0
0 0 1 5 0 4 3 0 0
1 0 0 0 9 0 0 0 6
0 3 0 0 0 0 0 9 0
5 0 0 0 4 0 0 0 3
0 0 8 3 0 7 2 0 0
0 0 0 0 8 0 0 0 0
0 5 3 4 0 6 7 1 0