0 0 9 5 0 4 0 8 0
0 0 0 0 6 0 5 0 7
1 0 0 0 0 2 0 9 0
9 0 0 0 0 0 0 6 3 
0 8 0 0 0 0 0 1 0
4 3 0 0 0 0 0 0 9
0 7 0 8 0 0 0 0 1
3 0 8 0 7 0 0 0 0 
0 6 0 3 0 9 7 0 0 
