0 0 0 0 0 0 0 0 0
0 0 3 4 0 8 5 0 0
6 8 0 0 3 0 0 7 1
9 0 8 6 0 3 1 0 4
0 2 0 0 0 0 0 8 0
3 0 4 9 0 2 7 0 5
1 9 0 0 6 0 0 4 8
0 0 2 8 0 9 3 0 0 
0 0 0 0 0 0 0 0 0
